"Date","Time","Remark","Party","Category","Mode","Cash In","Cash Out","Balance"
"10 Apr 2022","07:54 PM","SQ SALARY","","Salary","DBBL","43716","","43716"
"10 Apr 2022","10:34 PM","DBBL","","Loan","Cash","","6100","37616"
"10 Apr 2022","10:35 PM","Father+Mother","","Family","DBBL","","2015","35601"
"11 Apr 2022","10:37 PM","Himaloya=110,Fair & Lovely=65,Sola But=40,Teaste me=10","","Regular Bazar","Cash","","225","35376"
"12 Apr 2022","10:35 PM","Job Apply","","Job Application","Teletalk","","2031","33345"
"12 Apr 2022","10:37 PM","Home Rent March 22","","Home Rent","Cash","","6000","27345"
"12 Apr 2022","10:37 PM","Rabeya","","Family","Cash","","7000","20345"
"12 Apr 2022","10:37 PM","Regular Bazar + Touger(20+500+35+270+285+55+200+30+20+800+35+20)","","Regular Bazar","Cash","","590","19755"
"13 Apr 2022","10:37 PM","Books=550,Local Bus=20","","Regular Bazar","Cash","","570","19185"
"13 Apr 2022","10:37 PM","Go to Bogura-Local=20,Ticket=500,Food village=35,Sweets=270,Fruits=285,CNG-Van=55,Father=200,Shymol=30,CNG=20,Ticket=800,Food village=35,Local=20","","Tour","Cash","","2270","16915"
"16 Apr 2022","10:46 PM","Teaste me=20,Beguni-peyaju=15,Paper pin-Perek=30,Chips=10,Sugar=40","","Regular Bazar","Cash","","115","16800"
"19 Apr 2022","05:25 PM","Zaheda - Due=3000","","Loan","DBBL","","2000","14800"
"19 Apr 2022","10:33 PM","SQ Bonus of Eid-Ul-Fitr","","Salary","DBBL","24750","","39550"
"19 Apr 2022","10:46 PM","Local Bus to Kallaynpur","","Tour","Cash","","40","39510"
"19 Apr 2022","10:56 PM","Recharge average","","Mobile Recharge","DBBL","","296","39214"
"20 Apr 2022","03:40 PM","Shampoo=5","","Regular Bazar","Cash","","5","39209"
"20 Apr 2022","06:44 PM","Recharge Sent to Rocket","","Mobile Recharge","DBBL","","100","39109"
"21 Apr 2022","11:18 AM","Recharge MB to Rabeya","","Mobile Recharge","DBBL","","19","39090"
"21 Apr 2022","04:49 PM","Recharge Rabeya","","Mobile Recharge","DBBL","","15","39075"
"21 Apr 2022","04:50 PM","Bazar","","Regular Bazar","Cash","","69","39006"
"22 Apr 2022","06:09 PM","Ifter","","Regular Bazar","Cash","","25","38981"
"23 Apr 2022","11:07 AM","Recharge Sent to Rocket","","Mobile Recharge","DBBL","","100","38881"
"23 Apr 2022","01:46 PM","Bazar","","Regular Bazar","Cash","","65","38816"
"23 Apr 2022","05:38 PM","Father for goes to Rabeya's home","","Family","DBBL","","1530","37286"
"24 Apr 2022","09:47 AM","Ticket","","Tour","DBBL","","880","36406"
"24 Apr 2022","07:52 PM","Mobile Recharge","","Mobile Recharge","Cash","","50","36356"
"25 Apr 2022","05:41 PM","Salary half month of April","","Salary","DBBL","28716.75","","65072.75"
"25 Apr 2022","05:43 PM","Bazar","","Regular Bazar","Cash","","189","64883.75"
"25 Apr 2022","07:23 PM","Mobile Recharge","","Mobile Recharge","DBBL","","60","64823.75"
"26 Apr 2022","01:53 AM","DBBL Loan full payment","","Bills","DBBL","","31820","33003.75"
"26 Apr 2022","03:35 PM","Mobile Recharge to Rabeya","","Mobile Recharge","DBBL","","42","32961.75"
"26 Apr 2022","03:36 PM","Local Bus to Rajlakkhi to Home","","Regular Bazar","Cash","","130","32831.75"
"26 Apr 2022","04:45 PM","Medicine for Samiul","","Family","Cash","","800","32031.75"
"26 Apr 2022","07:12 PM","Ifter Bazar","","Regular Bazar","Cash","","65","31966.75"
"27 Apr 2022","03:45 PM","Heir Cut","","Bills","Cash","","280","31686.75"
"27 Apr 2022","06:21 PM","Ifter","","Regular Bazar","Cash","","45","31641.75"
"27 Apr 2022","10:55 PM","Two t-shirt","","Shopping","Cash","","300","31341.75"
"28 Apr 2022","02:40 PM","Father for Eid Fufu","","Family","DBBL","","820","30521.75"
"28 Apr 2022","04:08 PM","Care taker","","Gift","Cash","","200","30321.75"
"28 Apr 2022","08:59 PM","Bus+pan+Ifter+mirinda","","Regular Bazar","Cash","","438","29883.75"
"29 Apr 2022","01:51 AM","Sehori-Biriyani=140,Kichuri=50,Shosa=10","","Regular Bazar","Cash","","200","29683.75"
"29 Apr 2022","06:15 AM","CNG+APPLE","","Regular Bazar","Cash","","170","29513.75"
"29 Apr 2022","07:15 PM","Transport","","Tour","Cash","","870","28643.75"
"29 Apr 2022","07:16 PM","Doctor to Bogura, Visit=600,Test=1480(due=480),Fruto=50","","Bills","Cash","","1650","26993.75"
"29 Apr 2022","08:15 PM","Biscuit=55,Van=5","","Regular Bazar","Cash","","60","26933.75"
"30 Apr 2022","03:39 PM","To Father for going Rafiqul caca","","Regular Bazar","Cash","","510","26423.75"
"30 Apr 2022","06:37 PM","Doctor - Trans=75,Due test amount=480,Photocopy=5","","Medicine","Cash","","565","25858.75"
"30 Apr 2022","10:50 PM","Trans=125,Medicine=470,Fruits=300, Back from Bogura","","Tour","Cash","","895","24963.75"
"01 May 2022","10:00 AM","Rabeya return","","Return","Cash","2000","","26963.75"
"01 May 2022","03:54 PM","Shahidul vai","","Gift","Cash","","300","26663.75"
"01 May 2022","05:12 PM","Light 3 pieces","","Tour","Cash","","450","26213.75"
"01 May 2022","08:59 PM","Shaymol=12,Sonatola=30,Mokamtola=30,Gaibandha=70,Ice creme=10,Stand=10,eat=17,Lakhipur=30,Tel-Shaban=270,Chal=215,fish-zilapi=200,van=20,Medicine=85","","Tour","Cash","","999","25214.75"
"01 May 2022","09:08 PM","Ticket","","Tour","Cash","","1170","24044.75"
"02 May 2022","11:06 AM","Holder+Jaidul","","Tour","Cash","","40","24004.75"
"02 May 2022","04:31 PM","Ma+baba","","Tour","Cash","","70","23934.75"
"02 May 2022","10:41 PM","Ifter=150+55,oil+Light=550,van=20","","Regular Bazar","Cash","","775","23159.75"
"03 May 2022","09:39 AM","Shihab=10,Munni=100","","Gift","Cash","","110","23049.75"
"04 May 2022","12:05 AM","Owshod=31,sprite=25","","Medicine","Cash","","56","22993.75"
"04 May 2022","07:41 PM","Mobile Recharge","","Mobile Recharge","Cash","","20","22973.75"
"04 May 2022","08:23 PM","Van","","Regular Bazar","Cash","","20","22953.75"
"04 May 2022","08:23 PM","Software","","Bills","Cash","","3000","19953.75"
"05 May 2022","10:42 AM","Cha-cake = Tuku'r dokan","","Bills","Cash","","20","19933.75"
"05 May 2022","02:03 PM","Hamida Khala","","Gift","DBBL","","500","19433.75"
"05 May 2022","03:29 PM","Auto=50,Nirob=50,Rikshaw=20,Bus=100,cng=40 -> Bogura","","Bills","Cash","","260","19173.75"
"05 May 2022","04:28 PM","Sweets+Doi+Zilaphi=490,Vegis=22,Chips=40,Van=15,Tape=15","","Bills","Cash","","582","18591.75"
"05 May 2022","05:01 PM","Mithai","","Regular Bazar","Cash","","13","18578.75"
"05 May 2022","10:02 PM","Raisha","","Gift","Cash","","100","18478.75"
"05 May 2022","10:02 PM","Chicken","","Regular Bazar","Cash","","580","17898.75"
"05 May 2022","10:08 PM","Ice-cream=70,Mojo=15,choklet=5,belun=10,biscuit=50,comla=180,Van=20","","Regular Bazar","Cash","","350","17548.75"
"06 May 2022","09:13 PM","Rabeya","","Family","Cash","","1100","16448.75"
"06 May 2022","09:13 PM","Bushra-Tasnimul","","Gift","Cash","","150","16298.75"
"07 May 2022","12:45 AM","Bogura to Dhaka","","Tour","Cash","","476","15822.75"
"07 May 2022","07:50 AM","Rabeya Mobile Recharge","","Mobile Recharge","Cash","","20","15802.75"
"07 May 2022","09:00 AM","Office","","Office Transport","Cash","","49","15753.75"
"07 May 2022","07:56 PM","Begun,Alu,Peyaj,Egg,Cira,Moris","","Regular Bazar","Cash","","170","15583.75"
"08 May 2022","09:16 AM","Office","","Office Transport","Cash","","33","15550.75"
"08 May 2022","09:43 AM","Recharge","","Mobile Recharge","DBBL","","45","15505.75"
"08 May 2022","09:29 PM","Dirty Bill","","Dirty Bill","Cash","","120","15385.75"
"09 May 2022","08:58 AM","Office","","Office Transport","Cash","","45","15340.75"
"09 May 2022","12:48 PM","Lexus Biscuit","","Regular Bazar","Cash","","80","15260.75"
"09 May 2022","06:43 PM","Himaloya=110,Chanachur=10","","Regular Bazar","Cash","","120","15140.75"
"09 May 2022","07:57 PM","Mobile Recharge","","Mobile Recharge","Cash","","37","15103.75"
"10 May 2022","08:20 AM","Office","","Office Transport","Cash","","45","15058.75"
"10 May 2022","08:42 PM","Mobile Recharge","","Mobile Recharge","DBBL","","50","15008.75"
"11 May 2022","04:46 PM","Office","","Office Transport","Cash","","23","14985.75"
"11 May 2022","04:46 PM","Mobile Recharge","","Mobile Recharge","DBBL","","43","14942.75"
"11 May 2022","07:08 PM","April due Salary","","Salary","DBBL","15000","","29942.75"
"11 May 2022","08:56 PM","Chal,Egg,Shampoo","","Regular Bazar","Cash","","250","29692.75"
"12 May 2022","09:50 AM","Office","","Office Transport","Cash","","32","29660.75"
"12 May 2022","06:45 PM","Zhalmuri","","Regular Bazar","Cash","","10","29650.75"
"12 May 2022","06:57 PM","Flat Rent - April 22","","Home Rent","Cash","","6000","23650.75"
"12 May 2022","11:05 PM","Mobile Recharge","","Mobile Recharge","Cash","","20","23630.75"
"13 May 2022","11:58 AM","Mobile Recharge","","Mobile Recharge","DBBL","","50","23580.75"
"13 May 2022","06:46 PM","Mobile Recharge","","Mobile Recharge","DBBL","","50","23530.75"
"13 May 2022","07:45 PM","Peyaj, Alu, Chanachur, Banana","","Regular Bazar","Cash","","110","23420.75"
"14 May 2022","08:30 AM","Office","","Office Transport","Cash","","46","23374.75"
"14 May 2022","08:28 PM","Bus+Eat","","Regular Bazar","Cash","","50","23324.75"
"14 May 2022","09:28 PM","Shoe","","Shopping","Cash","","600","22724.75"
"14 May 2022","09:31 PM","Net Bill","","Net Bill","DBBL","","1000","21724.75"
"15 May 2022","10:26 AM","Breakfast","","Bills","Cash","","30","21694.75"
"15 May 2022","02:18 PM","Mobile Recharge","","Mobile Recharge","Cash","","20","21674.75"
"15 May 2022","07:50 PM","Cake=50,Vegis=50","","Regular Bazar","Cash","","100","21574.75"
"16 May 2022","09:00 AM","Office","","Office Transport","Cash","","53","21521.75"
"16 May 2022","12:51 PM","Lunch","","Bills","Cash","","70","21451.75"
"16 May 2022","05:32 PM","Tea,Shoe edit","","Bills","Cash","","30","21421.75"
"16 May 2022","05:32 PM","Mother","","Family","DBBL","","510","20911.75"
"16 May 2022","05:33 PM","Gass","","Gass Bill","Cash","","1400","19511.75"
"17 May 2022","09:51 AM","Office","","Office Transport","Cash","","45","19466.75"
"17 May 2022","04:24 PM","Mobile Recharge to Rabeya","","Mobile Recharge","DBBL","","15","19451.75"
"17 May 2022","07:49 PM","Safe+Eat","","Bills","Cash","","120","19331.75"
"17 May 2022","08:20 PM","01775326442","","Mobile Recharge","DBBL","","50","19281.75"
"18 May 2022","03:51 PM","Office","","Office Transport","Cash","","44","19237.75"
"18 May 2022","07:18 PM","Mobile Recharge","","Mobile Recharge","DBBL","","50","19187.75"
"19 May 2022","05:22 AM","Kallanpur=20,Ticket=500,Juice=30,Chips,cokolet=40,Baluahat=47","","Bills","Cash","","620","18567.75"
"19 May 2022","09:07 AM","Rabeya Return","","Family","Cash","4000","","22567.75"
"22 May 2022","09:07 AM","Josna bubu - Loan","","Family","Cash","","1300","21267.75"
"22 May 2022","09:10 AM","Adjustments for Ultrasonogram, Transport, Hospital (19 May - 22 May)","","Tour","Cash","","4730","16537.75"
"22 May 2022","11:07 AM","Send money from credit card for Hospital rent & Akika","","Loan","Cash","27000","","43537.75"
"27 May 2022","03:32 PM","Adjustments for Hospital=20000,Medicine=7800,Akika=8040,Trans,Shop (23 May - 27 May)","","Tour","Cash","","39869.75","3668"
"27 May 2022","09:27 PM","Rabeya=1000,Afiya=500","","Family","Cash","","1500","2168"
"28 May 2022","05:26 AM","Mokamtotal=25,Ticket=450,Home=35","","Transport","Cash","","510","1658"
"28 May 2022","08:30 AM","Office","","Office Transport","Cash","","55","1603"
"29 May 2022","08:44 AM","Office","","Office Transport","Cash","","33","1570"
"29 May 2022","06:50 PM","Egg(65), Energy biscuit(10), Meril Soap(45)","","Regular Bazar","Cash","","120","1450"
"30 May 2022","08:35 AM","Mobile Recharge to Rabeya","","Mobile Recharge","DBBL","","10","1440"
"30 May 2022","08:42 AM","Office, Badam","","Office Transport","Cash","","48","1392"
"30 May 2022","05:55 PM","Lunch","","Bills","Cash","","80","1312"
"30 May 2022","07:48 PM","Radhuni, chanachur","","Regular Bazar","Cash","","35","1277"
"31 May 2022","08:49 AM","Office, Zhalmuri","","Office Transport","Cash","","52","1225"
"31 May 2022","07:45 PM","Project by Mustakin","","Profit","Cash","4700","","5925"
"01 Jun 2022","09:09 AM","Office","","Office Transport","Cash","","62","5863"
"01 Jun 2022","07:59 PM","Moglai=15,Ruti=20","","Regular Bazar","Cash","","35","5828"
"02 Jun 2022","09:56 AM","Office","","Office Transport","Cash","","60","5768"
"02 Jun 2022","01:57 PM","Pathao=150,Ticket=450,Lichi=30,Begging=10","","Transport","Cash","","640","5128"
"02 Jun 2022","03:03 PM","Popular=10,Doctor=500,Medicine=650+32,Dragon=190,Dress=215,Baluahat=(10+40+70+10),Malta,Lexus=120+70","","Tour","Cash","","1927","3201"
"02 Jun 2022","06:11 PM","Food village","","Tour","Cash","","120","3081"
"03 Jun 2022","10:02 PM","Rabeya","","Family","Cash","","1050","2031"
"03 Jun 2022","11:01 PM","Mokamtotal=20,Ticket=500,Dew=15,Basha=20","","Tour","Cash","","555","1476"
"04 Jun 2022","08:15 AM","Office","","Office Transport","Cash","","53","1423"
"04 Jun 2022","07:00 PM","Ramjan Friend - work in online","","Profit","Cash","700","","2123"
"04 Jun 2022","11:42 PM","Mobile Recharge","","Mobile Recharge","Cash","","59","2064"
"05 Jun 2022","08:42 AM","Office","","Office Transport","Cash","","72","1992"
"05 Jun 2022","07:17 PM","Chanacur=20,Biscuit=30,Gillete=5,Radhuni=10","","Regular Bazar","Cash","","65","1927"
"06 Jun 2022","08:16 AM","Office","","Office Transport","Cash","","44","1883"
"06 Jun 2022","06:56 PM","Begun,Potol","","Regular Bazar","Cash","","25","1858"
"06 Jun 2022","08:35 PM","Mobile Recharge","","Mobile Recharge","Cash","","79","1779"
"07 Jun 2022","08:33 AM","Office","","Office Transport","Cash","","42","1737"
"07 Jun 2022","07:19 PM","Chanchur=10, Cake=30","","Regular Bazar","Cash","","40","1697"
"08 Jun 2022","08:20 AM","Office","","Office Transport","Cash","","55","1642"
"08 Jun 2022","12:21 PM","Lunch","","Bills","Cash","","80","1562"
"08 Jun 2022","05:24 PM","Recharge","","Mobile Recharge","Cash","","30","1532"
"09 Jun 2022","08:07 AM","Dirty","","Dirty Bill","Cash","","120","1412"
"09 Jun 2022","08:51 AM","Office","","Office Transport","Cash","","62","1350"
"09 Jun 2022","12:27 PM","Previous due DBBL Credit","","Loan","DBBL","","56","1294"
"09 Jun 2022","07:05 PM","Puri","","Bills","Cash","","20","1274"
"09 Jun 2022","09:02 PM","May Month Salary","","Salary","DBBL","43716","","44990"
"10 Jun 2022","10:54 AM","Gorur meat=370,Moshla+Dal=23,Porota=20","","Regular Bazar","Cash","","413","44577"
"10 Jun 2022","04:27 PM","Father=1500,Mother=500","","Family","DBBL","","2015","42562"
"10 Jun 2022","08:37 PM","Frypan=1540,Murgi prev deu=70,zhalmuri=10,Alu=50","","Regular Bazar","Cash","","1670","40892"
"10 Jun 2022","09:46 PM","Current Bill DESCO","","Current Bill","DBBL","","500","40392"
"11 Jun 2022","12:25 PM","Office","","Office Transport","Cash","","46","40346"
"11 Jun 2022","04:52 PM","Recharge","","Mobile Recharge","DBBL","","64","40282"
"11 Jun 2022","08:09 PM","Passport Print=30,NID Print=10","","Bills","Cash","","40","40242"
"12 Jun 2022","08:41 AM","Office","","Office Transport","Cash","","46","40196"
"12 Jun 2022","06:18 PM","Moglai","","Bills","Cash","","70","40126"
"12 Jun 2022","07:43 PM","Recharge","","Mobile Recharge","Cash","","40","40086"
"12 Jun 2022","08:29 PM","Basha vara June 22","","Home Rent","Cash","","6000","34086"
"13 Jun 2022","07:25 AM","Office","","Office Transport","Cash","","32","34054"
"13 Jun 2022","10:47 AM","Breakfast","","Bills","Cash","","30","34024"
"14 Jun 2022","07:20 AM","Breakfast","","Bills","Cash","","10","34014"
"14 Jun 2022","07:21 AM","Office, Rikshaw","","Office Transport","Cash","","62","33952"
"14 Jun 2022","12:21 PM","Rabeya","","Mobile Recharge","Cash","","42","33910"
"14 Jun 2022","08:05 PM","Heir Safe","","Bills","Cash","","50","33860"
"14 Jun 2022","08:07 PM","Recharge","","Mobile Recharge","Cash","","64","33796"
"14 Jun 2022","08:33 PM","Doctime","","Bills","Online","","157","33639"
"14 Jun 2022","10:59 PM","T-Shirt","","Shopping","Cash","","220","33419"
"14 Jun 2022","11:07 PM","Kallanpur,Mokamtola","","Tour","Cash","","830","32589"
"15 Jun 2022","06:22 AM","Lexus=70,CNG=26,Van=10","","Tour","Cash","","106","32483"
"15 Jun 2022","06:56 PM","Van=50,Chanacur-muri=40","","Tour","Cash","","90","32393"
"16 Jun 2022","06:56 PM","Chicken=210,Fish=400,Malta=170,Ice cream+Coca-cla=70,Van=20,Pampers=100,Shyamol=20","","Tour","Cash","","990","31403"
"17 Jun 2022","11:30 AM","Recharge","","Mobile Recharge","Cash","","20","31383"
"17 Jun 2022","09:27 PM","Ticket=450,Van-CNG=40,Spite=25,Bus=20","","Tour","Cash","","535","30848"
"17 Jun 2022","09:27 PM","Rabeya","","Family","Cash","","2000","28848"
"18 Jun 2022","07:27 AM","Office","","Office Transport","Cash","","28","28820"
"18 Jun 2022","11:00 AM","Breakfast","","Bills","Cash","","25","28795"
"18 Jun 2022","08:28 PM","Mobile Recharge","","Mobile Recharge","Cash","","40","28755"
"19 Jun 2022","08:13 AM","Office","","Office Transport","Cash","","22","28733"
"20 Jun 2022","07:40 AM","Office","","Office Transport","Cash","","32","28701"
"20 Jun 2022","10:54 AM","Recharge Alap","","Mobile Recharge","Cash","","20","28681"
"20 Jun 2022","07:21 PM","Himaloya","","Bills","Cash","","170","28511"
"21 Jun 2022","08:22 AM","Office","","Office Transport","Cash","","70","28441"
"21 Jun 2022","08:52 AM","Breakfast","","Bills","Cash","","20","28421"
"21 Jun 2022","10:52 AM","Recharge","","Mobile Recharge","Cash","","64","28357"
"21 Jun 2022","07:32 PM","Recharge","","Mobile Recharge","Cash","","20","28337"
"21 Jun 2022","07:33 PM","Dalbhaja","","Regular Bazar","Cash","","10","28327"
"27 Jun 2022","04:39 PM","Bubu","","Return","Cash","1300","","29627"
"27 Jun 2022","08:40 PM","Bonus-Eid ul Adha","","Salary","DBBL","24750","","54377"
"27 Jun 2022","10:42 PM","Adjustment-Shirt,Genji(2),Meat,Fish,Brush,Bazar,etc.","","Regular Bazar","Cash","","2911","51466"
"28 Jun 2022","06:51 PM","Recharge Alap","","Mobile Recharge","Cash","","20","51446"
"28 Jun 2022","09:40 PM","Ruti","","Bills","Cash","","20","51426"
"29 Jun 2022","12:00 PM","Samiul for Gazi motor","","Gift","DBBL","","5560","45866"
"29 Jun 2022","03:43 PM","Recharge Alap","","Mobile Recharge","Cash","","60","45806"
"30 Jun 2022","08:40 AM","To Father for Korbani & Invite from Bogura","","Family","Cash","","9545","36261"
"30 Jun 2022","10:39 PM","Ruti","","Bills","Cash","","20","36241"
"01 Jul 2022","10:45 AM","Heir Cut","","Bills","Cash","","150","36091"
"01 Jul 2022","11:22 AM","Meat=400,Moshla=20,Peyaj=45,Alu=30","","Regular Bazar","Cash","","495","35596"
"01 Jul 2022","10:24 PM","Ruti","","Bills","Cash","","25","35571"
"02 Jul 2022","11:45 AM","Recharge Alap","","Mobile Recharge","Cash","","40","35531"
"02 Jul 2022","06:46 PM","Making Shirt Pant","","Shopping","Cash","","850","34681"
"02 Jul 2022","07:30 PM","Kochukhet=30,Pant=750","","Shopping","Cash","","780","33901"
"02 Jul 2022","09:08 PM","Milk=40,Peyara=50","","Regular Bazar","Cash","","90","33811"
"03 Jul 2022","09:00 PM","chal,Egg,Ruti=190","","Regular Bazar","Cash","","190","33621"
"04 Jul 2022","09:34 AM","Recharge Father","","Mobile Recharge","Cash","","14","33607"
"04 Jul 2022","03:42 PM","Recharge","","Mobile Recharge","Cash","","40","33567"
"04 Jul 2022","08:50 PM","Milk 40,Mirinda 20","","Regular Bazar","Cash","","60","33507"
"04 Jul 2022","09:05 PM","Debit card yearly charge","","Regular Bazar","Cash","","460","33047"
"05 Jul 2022","01:40 AM","DBBL Credit Card Due","","Bills","DBBL","","27311","5736"
"05 Jul 2022","05:41 PM","Apple=120,Malta=100,Sweets=100,Khorma=40","","Regular Bazar","Cash","","460","5276"
"05 Jul 2022","10:48 PM","Doctime","","Bills","Cash","","157","5119"
"06 Jul 2022","10:45 AM","Recharge Alap","","Mobile Recharge","Cash","","60","5059"
"06 Jul 2022","08:40 PM","June Salary","","Salary","DBBL","43716","","48775"
"06 Jul 2022","08:41 PM","Pajama=400,Panjabi=1070,Bus=10","","Shopping","Cash","","1480","47295"
"06 Jul 2022","08:50 PM","Medicine - Fever","","Bills","Cash","","15","47280"
"07 Jul 2022","06:47 PM","Technical=60,Ticket =1600,Water=25,Chips=35,Water=40,Juice=35","","Tour","Cash","","1795","45485"
"08 Jul 2022","12:40 AM","Ruti,Bkash charge","","Regular Bazar","Cash","","37","45448"
"08 Jul 2022","05:11 PM","Fruits, Pineapples, Lexus, Transport","","Tour","Cash","","300","45148"
"09 Jul 2022","04:58 PM","To home transport=75","","Transport","Cash","","75","45073"
"10 Jul 2022","10:15 AM","Father=1000,Shopna bubu=1000,Munni=100,Eid ul adha=90,Bat,Samiul=100","","Gift","Cash","","2210","42863"
"11 Jul 2022","10:58 AM","Fruits","","Tour","Cash","","150","42713"
"11 Jul 2022","12:58 PM","Alif","","Gift","Cash","","100","42613"
"11 Jul 2022","08:10 PM","Home to Baluahat","","Tour","Cash","","45","42568"
"11 Jul 2022","08:15 PM","Shopping","","Shopping","Cash","","2800","39768"
"13 Jul 2022","02:43 PM","7up","","Bills","Cash","","100","39668"
"13 Jul 2022","06:15 PM","Father=500,Liton=100 for dulavai","","Family","Cash","","600","39068"
"13 Jul 2022","07:21 PM","Doi,Fish,Transport(Atapara)","","Tour","Cash","","1100","37968"
"14 Jul 2022","07:21 PM","Fruits,Transport(Boriyahat)=600,Tasnimul=100","","Bills","Cash","","700","37268"
"14 Jul 2022","08:15 PM","Munju vai=2500,Faruk vai=2500","","Gift","Cash","5000","","42268"
"14 Jul 2022","10:21 PM","Medicine Rabeya","","Bills","Cash","","190","42078"
"15 Jul 2022","10:15 AM","Rabeya","","Return","Cash","","5000","37078"
"15 Jul 2022","04:58 PM","Personal=64,Official=100,Alap=15,Rabeya=40","","Tour","Cash","","219","36859"
"15 Jul 2022","10:15 PM","Ticket=800,Juice=30,Transport=70","","Tour","Cash","","900","35959"
"16 Jul 2022","08:45 AM","Egg=60,Chanachur=40,Biscuit=10","","Regular Bazar","Cash","","110","35849"
"16 Jul 2022","07:26 PM","Basha vara-July","","Home Rent","Cash","","6000","29849"
"16 Jul 2022","07:26 PM","Rice=165,Soap=58","","Regular Bazar","Cash","","223","29626"
"17 Jul 2022","07:50 PM","Adjustment Eid ul Adha","","Tour","Cash","","352","29274"
"17 Jul 2022","07:54 PM","Current Recharge","","Current Bill","Cash","","1000","28274"
"18 Jul 2022","08:55 AM","Recharge Alap","","Mobile Recharge","Cash","","20","28254"
"18 Jul 2022","08:56 AM","Mango=55,Papiya=55,Potol=15,Shosha=50","","Regular Bazar","Cash","","175","28079"
"18 Jul 2022","08:00 PM","Recharge Rabeya","","Mobile Recharge","Cash","","42","28037"
"18 Jul 2022","08:30 PM","Vim=35,Ruti=30","","Regular Bazar","Cash","","65","27972"
"19 Jul 2022","09:39 AM","Napa","","Bills","Cash","","10","27962"
"19 Jul 2022","09:46 PM","Nirob for Najma bubu","","Gift","Cash","","810","27152"
"19 Jul 2022","09:46 PM","Mobile Recharge","","Mobile Recharge","Cash","","64","27088"
"20 Jul 2022","09:30 AM","Mobile Recharge","","Mobile Recharge","Cash","","50","27038"
"20 Jul 2022","09:30 AM","Ruti-vaji=40.Tea=10,Ada=15","","Regular Bazar","Cash","","65","26973"
"21 Jul 2022","10:47 AM","Mobile Recharge","","Mobile Recharge","Cash","","20","26953"
"21 Jul 2022","08:52 PM","Mobile Recharge Official","","Mobile Recharge","Cash","","20","26933"
"21 Jul 2022","08:52 PM","Badam=10,Ruti=25,Tea Bag=90","","Regular Bazar","Cash","","125","26808"
"22 Jul 2022","08:56 AM","Recharge","","Mobile Recharge","Cash","","120","26688"
"22 Jul 2022","01:41 PM","Murgi=290,Moshla,Lexus,Alu=35","","Regular Bazar","Cash","","325","26363"
"23 Jul 2022","08:48 PM","Alu,Moris,Begun=55,Chanacur=10","","Regular Bazar","Cash","","65","26298"
"23 Jul 2022","08:49 PM","Mobile Recharge","","Mobile Recharge","Cash","","20","26278"
"23 Jul 2022","10:26 PM","Net Bill","","Net Bill","Cash","","1000","25278"
"23 Jul 2022","10:26 PM","Mobile Recharge to Father","","Mobile Recharge","Cash","","38","25240"
"25 Jul 2022","01:07 AM","Sariful","","Loan","DBBL","","1500","23740"
"25 Jul 2022","01:07 AM","Transport=15,Fan=1450,Light=140,Khorma=20","","Shopping","Cash","","1625","22115"
"25 Jul 2022","01:09 AM","Mobile Recharge","","Mobile Recharge","Cash","","120","21995"
"26 Jul 2022","12:21 AM","Sorishar Oil","","Regular Bazar","Cash","","90","21905"
"26 Jul 2022","06:02 PM","Ticket for Mokamtola to Dhaka","","Tour","Cash","","3360","18545"
"26 Jul 2022","08:02 PM","Egg=40,Vegis=15,Chanacur=10","","Regular Bazar","Cash","","65","18480"
"26 Jul 2022","08:18 PM","Project - UIC-Inter","","Profit","Cash","10000","","28480"
"27 Jul 2022","10:05 PM","To Gaibandha - Local=15,Ticket=550,Bari=50","","Tour","Cash","","615","27865"
"28 Jul 2022","02:40 AM","Doi=200,Sweets=180","","Tour","Cash","","380","27485"
"28 Jul 2022","12:11 PM","Mobile Recharge to Ma","","Mobile Recharge","Cash","","20","27465"
"28 Jul 2022","03:14 PM","Minu=500, Ma=100,Shopna Bubu=200","","Gift","Cash","","800","26665"
"28 Jul 2022","03:14 PM","Cira","","Regular Bazar","Cash","","100","26565"
"28 Jul 2022","04:15 PM","To Baluahat - Trans=185,Fish=350","","Tour","Cash","","475","26090"
"29 Jul 2022","10:06 AM","Father=500,Samiul=100,Tasnimul=100,Shyamol=50","","Gift","Cash","","750","25340"
"29 Jul 2022","10:07 AM","To Dhaka,Trans=150,Tea=35,Water=20,Lunch=190,CNG=300","","Tour","Cash","","695","24645"
"29 Jul 2022","11:24 PM","Akika Heir weight","","Gift","Cash","","300","24345"
"30 Jul 2022","07:23 PM","Bazar-Alu-Peyaz,Vegis,Roshun,Lau,Dabur,Coconut oil","","Regular Bazar","Cash","","445","23900"
"31 Jul 2022","05:05 PM","Sariful","","Loan","Bkash","1500","","25400"
"31 Jul 2022","07:08 PM","Sugar,Shemai,Chanacur,Biscuit,Shampoo","","Regular Bazar","Cash","","120","25280"
"01 Aug 2022","11:02 AM","Fish=260,Peyara=48","","Regular Bazar","Cash","","308","24972"
"01 Aug 2022","11:02 AM","Medicine - Calcexen","","Medicine","Cash","","95","24877"
"01 Aug 2022","04:47 PM","DIM Light=23,Holder=90,Bread=25","","Bills","Cash","","138","24739"
"02 Aug 2022","01:15 PM","CODOMO Soap","","Shopping","Cash","","115","24624"
"02 Aug 2022","07:42 PM","Rack","","Shopping","Cash","","1150","23474"
"03 Aug 2022","10:53 AM","To Father","","Family","Bkash","","510","22964"
"03 Aug 2022","07:32 PM","Egg=68,Dal=70,Vegis=90","","Regular Bazar","Cash","","228","22736"
"03 Aug 2022","07:32 PM","Ferozi CI","","Medicine","Cash","","40","22696"
"04 Aug 2022","01:41 PM","To Father","","Family","Bkash","","300","22396"
"04 Aug 2022","06:57 PM","Toast","","Regular Bazar","Cash","","80","22316"
"05 Aug 2022","09:31 AM","Heir Cut","","Bills","Cash","","160","22156"
"05 Aug 2022","01:43 PM","For bubu","","Medicine","Cash","","100","22056"
"05 Aug 2022","06:43 PM","Alu=55,Radhuni=18,White Alach=30,Fish=90","","Regular Bazar","Cash","","193","21863"
"05 Aug 2022","10:43 PM","Adjustments for Bazar","","Regular Bazar","Cash","","1235","20628"
"06 Aug 2022","06:26 PM","Recharge","","Mobile Recharge","Cash","","53","20575"
"06 Aug 2022","08:23 PM","Fish=220+150,Vegis=130,Somucha=10","","Regular Bazar","Cash","","510","20065"
"06 Aug 2022","08:44 PM","Recharge to Rabeya","","Mobile Recharge","Cash","","42","20023"
"07 Aug 2022","09:23 AM","Cylender Gass","","Gass Bill","Cash","","1400","18623"
"07 Aug 2022","09:23 AM","M.P","","Medicine","Cash","","40","18583"
"07 Aug 2022","06:50 PM","Vegis=60,Sola=80","","Regular Bazar","Cash","","140","18443"
"07 Aug 2022","06:50 PM","Napa Syrup","","Medicine","Cash","","20","18423"
"07 Aug 2022","06:50 PM","T-Shirt","","Shopping","Cash","","380","18043"
"08 Aug 2022","10:45 AM","Shak=40,Whele=110,Peyaz=40,Chicken=320,Begun=30,Jira=48,Moshur=70,Alu=30","","Regular Bazar","Cash","","688","17355"
"08 Aug 2022","12:09 PM","Tika Charge","","Medicine","Cash","","150","17205"
"08 Aug 2022","12:10 PM","Detol Soap","","Regular Bazar","Cash","","30","17175"
"08 Aug 2022","03:41 PM","Egg=45,Chanacur=10","","Regular Bazar","Cash","","55","17120"
"08 Aug 2022","04:42 PM","Rikshaw","","Bills","Cash","","40","17080"
"10 Aug 2022","11:14 AM","Rabeya Return","","Return","Cash","5000","","22080"
"10 Aug 2022","03:06 PM","Bubu=1100","","Family","Cash","","1100","20980"
"10 Aug 2022","10:03 PM","Salary August 2022","","Salary","DBBL","43716","","64696"
"11 Aug 2022","03:06 PM","Father=3015","","Family","Cash","","3015","61681"
"13 Aug 2022","03:10 PM","Chal=350,Sobji=160+Alu,Peyaj=100","","Regular Bazar","Cash","","610","61071"
"13 Aug 2022","05:12 PM","August Basha Vara","","Home Rent","Cash","","6000","55071"
"16 Aug 2022","05:10 PM","Adjustment-Bazar etc.","","Regular Bazar","Cash","","1493","53578"
"16 Aug 2022","07:28 PM","Fish=260,Chicken=210,Vegis=150","","Regular Bazar","Cash","","620","52958"
"17 Aug 2022","07:18 PM","CNG, Lab AID","","Transport","Cash","","250","52708"
"18 Aug 2022","12:21 AM","Mobile Recharge","","Mobile Recharge","Cash","","100","52608"
"18 Aug 2022","08:21 AM","Fever","","Medicine","Cash","","70","52538"
"18 Aug 2022","11:18 AM","Father Hospotalized","","Family","Cash","","2040","50498"
"18 Aug 2022","08:17 PM","Moshari=250,Halim=80,Bus=30","","Regular Bazar","Cash","","460","50038"
"19 Aug 2022","07:08 PM","Misri=60,Napa Extra=30","","Regular Bazar","Cash","","90","49948"
"19 Aug 2022","09:23 PM","Regar=110,Chanacur=60,Alu=60","","Regular Bazar","Cash","","230","49718"
"20 Aug 2022","02:23 PM","Moxacil-6 pieces","","Medicine","Cash","","60","49658"
"20 Aug 2022","08:32 PM","Moglai=15,Muri=40,Chanacur=10","","Regular Bazar","Cash","","65","49593"
"20 Aug 2022","08:32 PM","Oil=185,Onion=40","","Regular Bazar","Cash","","225","49368"
"21 Aug 2022","05:05 AM","Lab Aid","","Transport","Cash","","200","49168"
"21 Aug 2022","08:25 AM","Dirty Bill September","","Dirty Bill","Cash","","120","49048"
"21 Aug 2022","01:03 PM","Samiul for ticket","","Gift","Cash","","600","48448"
"21 Aug 2022","01:06 PM","Samiul for Jomi Agreement, due=10000","","Savings","Cash","","40000","8448"
"21 Aug 2022","05:20 PM","Recharge","","Mobile Recharge","Cash","","54","8394"
"21 Aug 2022","05:20 PM","Father for Hospital","","Medicine","Cash","","1130","7264"
"21 Aug 2022","10:04 PM","Juice+RC=40","","Regular Bazar","Cash","","40","7224"
"22 Aug 2022","09:01 AM","Fish=150,Cake=60,Lemon=15,Juice+RC=40","","Regular Bazar","Cash","","265","6959"
"22 Aug 2022","01:04 PM","Mobile Recharge","","Mobile Recharge","Cash","","60","6899"
"23 Aug 2022","01:00 PM","Kodomo Head to Toe=190,Egg=40","","Regular Bazar","Cash","","230","6669"
"23 Aug 2022","08:21 PM","Chanacur=10,Biscuit=50","","Regular Bazar","Cash","","60","6609"
"24 Aug 2022","08:21 AM","Recharge","","Mobile Recharge","Cash","","30","6579"
"24 Aug 2022","04:58 PM","Firni Mixed","","Regular Bazar","Cash","","45","6534"
"25 Aug 2022","02:53 PM","Germ Kill Kit=700,Shampo=10.Chiken-polao=140","","Regular Bazar","Cash","","850","5684"
"25 Aug 2022","10:58 PM","Doctime Doctor Happy Heya","","Bills","Bkash","","157","5527"
"26 Aug 2022","04:52 PM","Orange=110,Dal=75,Morich=15","","Regular Bazar","Cash","","200","5327"
"26 Aug 2022","04:54 PM","Recharge","","Mobile Recharge","Cash","","120","5207"
"26 Aug 2022","08:24 PM","Father","","Family","Cash","","2550","2657"
"26 Aug 2022","08:25 PM","Medicine","","Medicine","Cash","","385","2272"
"26 Aug 2022","08:40 PM","Kitkat for Sinthiya","","Bills","Cash","","50","2222"
"27 Aug 2022","07:40 AM","Vegetable","","Regular Bazar","Cash","","40","2182"
"27 Aug 2022","02:31 PM","Sinthiya","","Shopping","Cash","","40","2142"
"27 Aug 2022","05:31 PM","Shammi","","Gift","Cash","","100","2042"
"28 Aug 2022","12:31 PM","Fish=380+50,Vegis=25,Potol=40,Peyaj=40","","Regular Bazar","Cash","","535","1507"
"28 Aug 2022","06:01 PM","Bazar, Alu,Egg etc","","Regular Bazar","Cash","","100","1407"
"29 Aug 2022","10:53 AM","Sobhanbug to Shewrapara","","Transport","Cash","","20","1387"
"29 Aug 2022","02:43 PM","Suji=48,Sugar=43","","Regular Bazar","Cash","","93","1294"
"29 Aug 2022","06:21 PM","Bus=30,Soup=45,Monas=32","","Bills","Cash","","134","1160"
"29 Aug 2022","07:44 PM","Rose flower","","Shopping","Cash","","10","1150"
"30 Aug 2022","06:01 PM","Rabeya","","Loan","Cash","500","","1650"
"31 Aug 2022","08:40 AM","Soyabil Oil","","Regular Bazar","Cash","","195","1455"
"31 Aug 2022","10:36 AM","Cylender Gass","","Gass Bill","Cash","","1450","5"
"31 Aug 2022","10:37 AM","Loan from Credit Card","","Loan","DBBL","2000","","2005"
"01 Sep 2022","09:01 AM","Adjustment-Bazar etc.","","Regular Bazar","Cash","","917","1088"
"03 Sep 2022","06:40 PM","Light=55,Ball=40","","Shopping","Cash","","95","993"
"03 Sep 2022","10:15 PM","Kacci","","Bills","Cash","","210","783"
"03 Sep 2022","10:31 PM","Bus","","Transport","Cash","","40","743"
"04 Sep 2022","10:40 AM","Fish=150,Roshun=35,Alu=40","","Regular Bazar","Cash","","225","518"
"05 Sep 2022","10:22 AM","Fish=125,Chicken=390,Potol=40,Shak=20","","Regular Bazar","Cash","","575","-57"
"05 Sep 2022","10:37 AM","Loan from Credit Card","","Loan","DBBL","1000","","943"
"05 Sep 2022","11:47 AM","Tika Charge","","Bills","Cash","","150","793"
"05 Sep 2022","11:47 AM","Ace plus","","Medicine","Cash","","30","763"
"05 Sep 2022","06:42 PM","Medicine","Rabeya","Medicine","Cash","","160","603"
"07 Sep 2022","10:59 AM","Mobile Recharge","","Mobile Recharge","Cash","","30","573"
"07 Sep 2022","06:43 PM","Shampoo=15,Potata=20","","Regular Bazar","Cash","","35","538"
"07 Sep 2022","07:44 PM","Doctime","","Bills","Cash","","99","439"
"08 Sep 2022","10:25 AM","Egg - 2 pieces","","Regular Bazar","Cash","","22","417"
"09 Sep 2022","02:34 PM","Ruti","","Regular Bazar","Cash","","20","397"
"09 Sep 2022","02:34 PM","Mobile Recharge","","Mobile Recharge","Cash","","20","377"
"10 Sep 2022","05:32 PM","Mobile Recharge","","Mobile Recharge","Cash","","20","357"
"10 Sep 2022","08:18 PM","Toast=80,Chanancur=10","","Regular Bazar","Cash","","90","267"
"11 Sep 2022","09:15 AM","Lau Shak=30, Morich=15","","Regular Bazar","Cash","","45","222"
"11 Sep 2022","07:48 PM","Salary September 2022","","Salary","SCB","43716","","43938"
"12 Sep 2022","08:02 AM","Loan from Credit Card","","Loan","DBBL","1000","","44938"
"12 Sep 2022","10:11 AM","Fish=850,Egg=65,Peyaj=50","","Regular Bazar","Cash","","965","43973"
"12 Sep 2022","07:01 PM","Mobile recharge","","Regular Bazar","Cash","","20","43953"
"12 Sep 2022","07:01 PM","Mobile Recharge","","Mobile Recharge","Cash","","20","43933"
"12 Sep 2022","07:15 PM","Rabeya","Rabeya","Loan","Cash","","500","43433"
"12 Sep 2022","07:51 PM","Samiul for Jomi Agreement","","Savings","Cash","","10000","33433"
"12 Sep 2022","07:51 PM","September Basha vara","","Home Rent","Cash","","6000","27433"
"12 Sep 2022","07:51 PM","Desco Recharge","","Current Bill","Cash","","900","26533"
"12 Sep 2022","07:51 PM","Father=2500,Mother=500","","Family","DBBL","","2550","23983"
"12 Sep 2022","08:06 PM","Ostocal, Firozi CI, Dexilend, Fixocard","","Medicine","Cash","","220","23763"
"12 Sep 2022","08:06 PM","Begun=30,Korola=30,Potol=35+15","","Regular Bazar","Cash","","110","23653"
"12 Sep 2022","08:17 PM","Sugar,oil,dal,Blade etc.","","Regular Bazar","Cash","","870","22783"
"13 Sep 2022","07:43 PM","Chikhen-Nan","","Bills","Cash","","150","22633"
"13 Sep 2022","07:43 PM","Jama","Afiya","Shopping","Cash","","80","22553"
"13 Sep 2022","09:00 PM","Toshok","","Shopping","Cash","","1750","20803"
"14 Sep 2022","11:53 AM","Butter Fish","","Regular Bazar","Cash","","80","20723"
"14 Sep 2022","06:54 PM","Olive oil,v,=370,Mobile batter=250,Sandel=50","","Shopping","Cash","","670","20053"
"14 Sep 2022","08:57 PM","Mobile Recharge","","Mobile Recharge","Cash","","20","20033"
"14 Sep 2022","08:57 PM","Singara,Alu chop","","Bills","Cash","","15","20018"
"14 Sep 2022","08:59 PM","Best buy-Table=3150,Chair(2)=1220","","Shopping","Cash","","4390","15628"
"15 Sep 2022","10:00 AM","Shak,Alu,Chanacur","","Regular Bazar","Cash","","60","15568"
"16 Sep 2022","01:43 PM","Meat=470,Fish=120,shak=25,Potol=50,Amloki=10","","Regular Bazar","Cash","","675","14893"
"16 Sep 2022","01:43 PM","Zhunzhuni","Afiya","Shopping","Cash","","20","14873"
"16 Sep 2022","01:43 PM","Heir Cut","","Bills","Cash","","300","14573"
"16 Sep 2022","06:19 PM","Semai,Biscuit","","Regular Bazar","Cash","","60","14513"
"16 Sep 2022","07:15 PM","Sariful","","Loan","Cash","","1000","13513"
"17 Sep 2022","02:11 PM","Mobile Recharge","","Mobile Recharge","Cash","","30","13483"
"17 Sep 2022","08:54 PM","Evening Eat-Muri,Egg","","Bills","Cash","","45","13438"
"17 Sep 2022","08:54 PM","T-Shirt","","Shopping","Cash","","150","13288"
"17 Sep 2022","08:54 PM","B","Rabeya","Shopping","Cash","","120","13168"
"17 Sep 2022","08:54 PM","Table Sheed=400, Hand Towel=90","","Shopping","Cash","","490","12678"
"17 Sep 2022","08:54 PM","Flower","Afiya","Shopping","Cash","","30","12648"
"17 Sep 2022","08:54 PM","Bus","","Transport","Cash","","11","12637"
"18 Sep 2022","01:24 PM","Send to Father for Afiya Birth Registration","Afiya","Family","Bkash","","300","12337"
"18 Sep 2022","02:24 PM","Egg","","Regular Bazar","Cash","","70","12267"
"19 Sep 2022","12:46 AM","Alu=60,Peyaz=40,Moris=20,Jira gura=15,Chanacur=5","","Regular Bazar","Cash","","140","12127"
"19 Sep 2022","01:37 PM","To Mother","","Family","Cash","","200","11927"
"19 Sep 2022","06:37 PM","Mobile Recharge","","Mobile Recharge","Cash","","40","11887"
"19 Sep 2022","10:20 PM","Bus=50","","Transport","Cash","","50","11837"
"19 Sep 2022","10:20 PM","Soup=45,Bir(f)=20","","Regular Bazar","Cash","","65","11772"
"20 Sep 2022","12:20 PM","Mobile Recharge","","Mobile Recharge","Cash","","30","11742"
"20 Sep 2022","10:23 PM","Peyara=70,Malta=40,Chanacur=10,Fire Box=4","","Regular Bazar","Cash","","125","11617"
"20 Sep 2022","10:23 PM","Net Bill - 2 Month, due 1 month","","Net Bill","Cash","","1000","10617"
"21 Sep 2022","10:15 AM","Holud","","Regular Bazar","Cash","","28","10589"
"21 Sep 2022","10:15 AM","Heir Rubber","Rabeya","Shopping","Cash","","5","10584"
"21 Sep 2022","05:30 PM","Dirty Bill","","Dirty Bill","Cash","","120","10464"
"21 Sep 2022","08:35 PM","Mobile Recharge","","Mobile Recharge","Cash","","50","10414"
"22 Sep 2022","09:28 PM","Rabeya","","Loan","Cash","500","","10914"
"22 Sep 2022","09:29 PM","Tauger=380,T-Shirt=150 for Samiul","","Shopping","Cash","","530","10384"
"22 Sep 2022","09:29 PM","Shosha=20,Banana=40","","Regular Bazar","Cash","","60","10324"
"23 Sep 2022","10:52 AM","Mobile Recharge","","Mobile Recharge","Cash","","50","10274"
"24 Sep 2022","12:03 PM","Fish=150,Potol=50,Roshun=35,Shosha=30","","Regular Bazar","Cash","","265","10009"
"24 Sep 2022","12:03 PM","Max Pro","","Medicine","Cash","","14","9995"
"25 Sep 2022","10:52 AM","Mobile Recharge","","Mobile Recharge","Cash","","36","9959"
"26 Sep 2022","01:02 PM","Fish=210,Peyaj=20,Full Copy=30,Shosha=30","","Regular Bazar","Cash","","290","9669"
"26 Sep 2022","07:39 PM","Medicine","Rabeya","Medicine","Cash","","180","9489"
"26 Sep 2022","07:41 PM","Alu=30,Juice=20","","Regular Bazar","Cash","","50","9439"
"27 Sep 2022","08:51 AM","Porota=60","","Bills","Cash","","60","9379"
"27 Sep 2022","08:51 AM","Bus=40,CNG=120,Rikhshaw=30","","Transport","Cash","","190","9189"
"28 Sep 2022","02:15 PM","Degree Admission for Shaheen vai","","Bills","Cash","","3905","5284"
"28 Sep 2022","08:20 PM","Cotton=45,Canacur=10","","Regular Bazar","Cash","","55","5229"
"28 Sep 2022","08:21 PM","Alu=30,Egg=70,Badam=40,Shampo=15","","Regular Bazar","Cash","","155","5074"
"29 Sep 2022","06:17 PM","Restaurant","","Bills","Cash","","310","4764"
"30 Sep 2022","11:17 AM","Vegetables=95,Malta=105","","Regular Bazar","Cash","","200","4564"
"01 Oct 2022","06:08 PM","Pitha","","Bills","Cash","","15","4549"
"02 Oct 2022","10:08 AM","Rui Fish=235,Full Copy=40","","Regular Bazar","Cash","","275","4274"
"02 Oct 2022","05:08 PM","Peyaju,Beguni","","Bills","Cash","","20","4254"
"02 Oct 2022","07:11 PM","Ostocal G=95,Cinaron=15","","Medicine","Cash","","110","4144"
"03 Oct 2022","03:48 PM","Biscuit chanacur","","Regular Bazar","Cash","","25","4119"
"04 Oct 2022","12:48 AM","Father","","Mobile Recharge","Cash","","14","4105"
"04 Oct 2022","06:49 PM","Sariful - Return money by Nagad- 1000Tk.","","Loan","Cash","1000","","5105"
"04 Oct 2022","11:04 PM","Alu-peyaj=100,lau-potol=80,Muri=40","","Regular Bazar","Cash","","220","4885"
"04 Oct 2022","11:06 PM","Recharge Internet","","Net Bill","Cash","","138","4747"
"05 Oct 2022","02:48 PM","Rui Fish - 2 KG","","Regular Bazar","Cash","","680","4067"
"05 Oct 2022","05:22 PM","Fuska","","Bills","Cash","","30","4037"
"06 Oct 2022","02:02 PM","Office","","Office Transport","Cash","","85","3952"
"06 Oct 2022","07:05 PM","Brush","","Mobile Recharge","Cash","","30","3922"
"06 Oct 2022","07:29 PM","Bus","","Transport","Cash","","15","3907"
"06 Oct 2022","08:00 PM","2/3 Quater=320,TShort=240,Short pant=100","","Shopping","Cash","","660","3247"
"06 Oct 2022","08:29 PM","Himaloya Aloe vera","","Regular Bazar","Cash","","190","3057"
"07 Oct 2022","10:31 PM","Salary October 2022","","Salary","SCB","43716","","46773"
"07 Oct 2022","11:23 PM","Egg","","Regular Bazar","Cash","","50","46723"
"07 Oct 2022","11:23 PM","Mobile Recharge","Rabeya","Mobile Recharge","Cash","","42","46681"
"07 Oct 2022","11:23 PM","Rabeya gift","Rabeya","Gift","Cash","","100","46581"
"07 Oct 2022","11:23 PM","Rikshaw,Bus","","Transport","Cash","","105","46476"
"07 Oct 2022","11:23 PM","Token money by office","","Gift","Cash","5300","","51776"
"07 Oct 2022","11:27 PM","Honey comb,Water","","Tour","Cash","","30","51746"
"07 Oct 2022","11:27 PM","Lotary token 4 pieces","","Gift","Cash","","400","51346"
"07 Oct 2022","11:28 PM","Credit card payment","","Loan","DBBL","","4046","47300"
"08 Oct 2022","10:42 AM","Breakfast","","Tour","Cash","","100","47200"
"08 Oct 2022","03:43 PM","Lunch","","Tour","Cash","","250","46950"
"09 Oct 2022","11:19 AM","Tour: Mini Bandorbn,Himchori,Inani Beach, Trans=300,Anarcoli=20,Dab=170","Sohel","Tour","Cash","","490","46460"
"09 Oct 2022","05:00 PM","Lunch(Ruti,Dal)=45,","","Tour","Cash","","64","46396"
"09 Oct 2022","05:07 PM","To Barmis Market","","Transport","Cash","","40","46356"
"09 Oct 2022","07:07 PM","Shutki=1020,Acher=1160","","Shopping","Cash","","2180","44176"
"09 Oct 2022","11:07 PM","Ball=80
Kumir=400
Talking tom=400
Dol=150
Cap=130
Mala=230","Afiya","Shopping","Cash","","1390","42786"
"09 Oct 2022","11:07 PM","3 Pieces=1200,Bag=100","Rabeya","Shopping","Cash","","1300","41486"
"10 Oct 2022","07:22 PM","Lunch,P=420","Sohel","Tour","Cash","","420","41066"
"11 Oct 2022","02:29 AM","Office for Transport","","Gift","Cash","200","","41266"
"11 Oct 2022","05:29 AM","Panthopoth to Shewrapara","","Transport","Cash","","100","41166"
"11 Oct 2022","06:29 AM","Rabeya=100,Afiya=100","","Gift","Cash","","200","40966"
"11 Oct 2022","08:31 AM","Office","","Office Transport","Cash","","70","40896"
"11 Oct 2022","06:49 PM","Juice, CD","Rabeya","Regular Bazar","Cash","","60","40836"
"11 Oct 2022","07:52 PM","Alu=60,Kodor=40,Lau=60,Potol=24,Kola=30","","Regular Bazar","Cash","","214","40622"
"11 Oct 2022","07:52 PM","Brilliant","","Mobile Recharge","Cash","","30","40592"
"12 Oct 2022","09:00 AM","Breakfast","Sohel","Bills","Cash","","10","40582"
"12 Oct 2022","09:52 AM","Office","","Office Transport","Cash","","70","40512"
"12 Oct 2022","04:57 PM","Jomi bondok return=3000,Home=1500","","Family","Cash","","4500","36012"
"12 Oct 2022","06:56 PM","Gass","","Gass Bill","Cash","","1330","34682"
"12 Oct 2022","06:56 PM","Banana=50,Chanacur=10","","Regular Bazar","Cash","","60","34622"
"12 Oct 2022","07:02 PM","White Cement","","Regular Bazar","Cash","","30","34592"
"12 Oct 2022","07:40 PM","Basha vara-October","","Home Rent","Cash","","6000","28592"
"13 Oct 2022","08:55 AM","Office","","Office Transport","Cash","","70","28522"
"13 Oct 2022","10:42 AM","Mobile Recharge","Rabeya","Mobile Recharge","Cash","","42","28480"
"13 Oct 2022","10:42 AM","Brilliant","Sohel","Mobile Recharge","Cash","","30","28450"
"14 Oct 2022","10:20 AM","Monthly Bazar","","Regular Bazar","Cash","","910","27540"
"14 Oct 2022","10:35 AM","Rui=310,Koi fish=190,Broylar Chicken=280,Peyaj=45,Kumra=30","","Regular Bazar","Cash","","855","26685"
"14 Oct 2022","03:57 PM","Rikshaw","","Transport","Cash","","120","26565"
"14 Oct 2022","04:00 PM","Ticket","","Tour","Cash","","100","26465"
"14 Oct 2022","05:00 PM","Juice","Rabeya","Tour","Cash","","30","26435"
"14 Oct 2022","06:00 PM","Brilliant","","Mobile Recharge","Cash","","30","26405"
"15 Oct 2022","08:59 AM","Office","","Office Transport","Cash","","45","26360"
"15 Oct 2022","11:55 AM","Mother for treatment","","Family","Bkash","","510","25850"
"15 Oct 2022","06:48 PM","Soyabil Oil,Ata","","Regular Bazar","Cash","","400","25450"
"16 Oct 2022","08:53 AM","Office","","Office Transport","Cash","","70","25380"
"16 Oct 2022","11:33 AM","Brilliant","","Mobile Recharge","Cash","","57","25323"
"16 Oct 2022","06:53 PM","Peyara=50","","Regular Bazar","Cash","","50","25273"
"16 Oct 2022","06:53 PM","Trimmer","Sohel","Shopping","Cash","","550","24723"
"16 Oct 2022","08:38 PM","Heir Cut","","Bills","Cash","","90","24633"
"17 Oct 2022","09:00 AM","Office","","Office Transport","Cash","","85","24548"
"17 Oct 2022","09:45 PM","Ostocal G=95,Ferozi CI=45","Rabeya","Medicine","Cash","","140","24408"
"18 Oct 2022","08:45 AM","Office","","Office Transport","Cash","","120","24288"
"18 Oct 2022","06:24 PM","Earphone","Sohel","Shopping","Cash","","100","24188"
"18 Oct 2022","07:41 PM","Rupali Life Insurance","","Savings","Cash","","11162","13026"
"18 Oct 2022","08:25 PM","Bouncing Chair","Afiya","Shopping","Cash","","850","12176"
"19 Oct 2022","12:47 PM","Mobile Recharge","Rabeya","Mobile Recharge","Cash","","42","12134"
"19 Oct 2022","12:47 PM","Office","","Office Transport","Cash","","85","12049"
"19 Oct 2022","06:40 PM","Banana","","Regular Bazar","Cash","","35","12014"
"20 Oct 2022","08:58 AM","office","","Office Transport","Cash","","70","11944"
"20 Oct 2022","08:58 AM","Briliant","","Mobile Recharge","Cash","","80","11864"
"20 Oct 2022","05:40 PM","Mixed Nutts for ma","","Bills","Cash","","600","11264"
"21 Oct 2022","10:29 AM","Friday bazar with fish","","Regular Bazar","Cash","","730","10534"
"21 Oct 2022","04:29 PM","Kacci vai","","Tour","Cash","","635","9899"
"21 Oct 2022","04:29 PM","Rikshaw","","Transport","Cash","","110","9789"
"21 Oct 2022","07:00 PM","Cook fry pan, jar","","Shopping","Cash","","755","9034"
"21 Oct 2022","09:00 PM","Fruits","","Regular Bazar","Cash","","200","8834"
"22 Oct 2022","09:00 AM","office","","Office Transport","Cash","","90","8744"
"22 Oct 2022","07:00 PM","Potata,Coffe","","Regular Bazar","Cash","","30","8714"
"23 Oct 2022","09:08 AM","office","","Office Transport","Cash","","45","8669"
"23 Oct 2022","07:59 PM","Bazar","","Regular Bazar","Cash","","210","8459"
"24 Oct 2022","08:59 AM","Office","","Office Transport","Cash","","65","8394"
"24 Oct 2022","07:07 PM","Brilliant","","Mobile Recharge","Cash","","50","8344"
"25 Oct 2022","08:59 AM","Office","","Office Transport","Cash","","79","8265"
"25 Oct 2022","08:59 PM","Holuder Gura=50,Chanacur=10","","Regular Bazar","Cash","","60","8205"
"26 Oct 2022","08:59 AM","Office","","Office Transport","Cash","","65","8140"
"27 Oct 2022","08:39 AM","Office","","Office Transport","Cash","","65","8075"
"27 Oct 2022","06:39 PM","Ata 2KG","","Regular Bazar","Cash","","120","7955"
"28 Oct 2022","11:41 AM","Brilliant","","Mobile Recharge","Cash","","50","7905"
"28 Oct 2022","11:41 AM","Potol=50,Alu=60,Telapiya fish=310,Gol Begun=40,Moris=20,Peyaz=50,Begun=46,Chanacur=10,Idur mara medicine=20","","Regular Bazar","Cash","","606","7299"
"29 Oct 2022","08:15 AM","Office","","Office Transport","Cash","","70","7229"
"29 Oct 2022","11:15 AM","Direct Entry Officer Navy","","Office Transport","SCB","","225","7004"
"29 Oct 2022","07:09 PM","Muri=40,Chanacur=10,Milk Powder=10","","Regular Bazar","Cash","","60","6944"
"30 Oct 2022","08:56 AM","Office","","Office Transport","Cash","","70","6874"
"31 Oct 2022","09:08 AM","Office","","Office Transport","Cash","","105","6769"
"31 Oct 2022","10:44 AM","Adjustment-Bazar etc.","","Regular Bazar","Cash","","488.75","6280.25"
"01 Nov 2022","08:00 AM","Meat","","Regular Bazar","Cash","","500","5780.25"
"01 Nov 2022","08:41 AM","Office","","Office Transport","Cash","","70","5710.25"
"02 Nov 2022","08:43 AM","Office","","Office Transport","Cash","","80","5630.25"
"03 Nov 2022","08:43 AM","Office","","Office Transport","Cash","","70","5560.25"
"04 Nov 2022","10:24 AM","Bazar(Fish,Moric,Cinigura Chal)=615,Pepsi=70,Potata=20,Shosha=30,Egg=70,Chanacur=10","","Regular Bazar","Cash","","815","4745.25"
"04 Nov 2022","04:28 PM","Dirty Bill","","Dirty Bill","Cash","","110","4635.25"
"04 Nov 2022","04:29 PM","Mobile Recharge","","Mobile Recharge","Cash","","80","4555.25"
"05 Nov 2022","08:24 AM","Office","","Office Transport","Cash","","70","4485.25"
"05 Nov 2022","10:23 AM","Nurunddin Sent to BKash","","Loan","Cash","","1005","3480.25"
"06 Nov 2022","08:30 AM","Office","","Office Transport","Cash","","70","3410.25"
"07 Nov 2022","12:21 AM","Breakfast","","Bills","Cash","","30","3380.25"
"07 Nov 2022","07:23 AM","Egg","","Regular Bazar","Cash","","70","3310.25"
"07 Nov 2022","08:23 AM","Office","","Office Transport","Cash","","70","3240.25"
"07 Nov 2022","09:00 AM","Office","","Office Transport","Cash","","70","3170.25"
"07 Nov 2022","05:23 PM","Mobile Net","","Net Bill","Cash","","40","3130.25"
"08 Nov 2022","12:00 AM","Breakfast","","Bills","Cash","","50","3080.25"
"08 Nov 2022","09:00 AM","Office","","Office Transport","Cash","","80","3000.25"
"08 Nov 2022","07:00 PM","Juta=1100,Pant=480","","Shopping","Cash","","1580","1420.25"
"08 Nov 2022","08:16 PM","Bazar etc.","","Regular Bazar","Cash","","689","731.25"
"09 Nov 2022","08:58 AM","Office","","Office Transport","Cash","","70","661.25"
"09 Nov 2022","09:30 AM","Cake,Chanacur,Biscuit","","Regular Bazar","Cash","","110","551.25"
"10 Nov 2022","08:58 AM","Office","","Office Transport","Cash","","50","501.25"
"10 Nov 2022","05:21 PM","November Salary 2022","","Salary","Cash","43716","","44217.25"
"10 Nov 2022","07:00 PM","C=30,Yoast=80,Chanacur=10","","Regular Bazar","Cash","","120","44097.25"
"11 Nov 2022","07:36 AM","Current Recharge","","Current Bill","Cash","","520","43577.25"
"11 Nov 2022","08:50 AM","To Savar","","Transport","Cash","","150","43427.25"
"11 Nov 2022","09:55 AM","Sweets","","Tour","Cash","","240","43187.25"
"11 Nov 2022","11:38 AM","Father","","Family","Cash","","2500","40687.25"
"11 Nov 2022","02:10 PM","Sinthiya","","Gift","Cash","","200","40487.25"
"11 Nov 2022","04:01 PM","Banglalink SIM","Rabeya","Gift","Cash","","50","40437.25"
"11 Nov 2022","04:09 PM","Oppo A16","Rabeya","Gift","Cash","","14000","26437.25"
"11 Nov 2022","04:52 PM","Peyara 1 KG","","Regular Bazar","Cash","","60","26377.25"
"11 Nov 2022","09:00 PM","Medicine","Rabeya","Medicine","Cash","","130","26247.25"
"11 Nov 2022","09:00 PM","Shampo, Conditionar=40, Chanacur=10","","Regular Bazar","Cash","","50","26197.25"
"12 Nov 2022","08:19 AM","Office","","Office Transport","Cash","","70","26127.25"
"12 Nov 2022","01:57 PM","Ma, Shihab","","Family","Cash","","1000","25127.25"
"12 Nov 2022","07:16 PM","House Rent","","Home Rent","Cash","","6000","19127.25"
"12 Nov 2022","08:05 PM","Moris=15,lebu=5,Alu=50,Peyaz=100,Roshun=80,Ada=40,Begun=40,Full copy😦=40,Pepe=50","","Regular Bazar","Cash","","470","18657.25"
"13 Nov 2022","06:38 PM","Office","","Office Transport","Cash","","70","18587.25"
"13 Nov 2022","06:58 PM","Muri=50,Soyabin oil=355,Soap=38,Solt=35,Sorishar oil=100","","Transport","Cash","","580","18007.25"
"14 Nov 2022","08:12 AM","Office","","Office Transport","Cash","","70","17937.25"
"14 Nov 2022","08:27 AM","Ruchi Chanacur","","Regular Bazar","Cash","","50","17887.25"
"14 Nov 2022","10:01 PM","Bazar","","Regular Bazar","Cash","","1060","16827.25"
"15 Nov 2022","08:27 AM","Office","","Office Transport","Cash","","70","16757.25"
"15 Nov 2022","07:03 PM","Mushur Dal 1/2 kg","","Regular Bazar","Cash","","70","16687.25"
"17 Nov 2022","08:08 AM","Office","","Office Transport","Cash","","70","16617.25"
"18 Nov 2022","09:08 AM","To Basila for Interview","","Transport","Cash","","70","16547.25"
"18 Nov 2022","02:10 PM","Lunch","","Bills","Cash","","100","16447.25"
"19 Nov 2022","08:47 AM","Office","","Office Transport","Cash","","60","16387.25"
"20 Nov 2022","08:47 AM","Office","","Office Transport","Cash","","70","16317.25"
"20 Nov 2022","08:00 PM","Bazar","","Regular Bazar","Cash","","560","15757.25"
"21 Nov 2022","06:44 AM","Multiple Tupi, Moja","","Shopping","Cash","","305","15452.25"
"21 Nov 2022","08:44 AM","Office","","Office Transport","Cash","","70","15382.25"
"21 Nov 2022","07:08 PM","Energy Biscuit","","Regular Bazar","Cash","","50","15332.25"
"22 Nov 2022","08:46 AM","Office","","Office Transport","Cash","","70","15262.25"
"22 Nov 2022","10:10 AM","Credit Card for Ticket Purchase","","Loan","Cash","2088","","17350.25"
"22 Nov 2022","10:13 AM","Ticket - Dhaka to Gaibandha","","Tour","Cash","","2088","15262.25"
"22 Nov 2022","06:27 PM","Suyetar","Afiya","Shopping","Cash","","300","14962.25"
"22 Nov 2022","08:27 PM","Muri=50,Juta Selai=150, Chicken=60","","Bills","Cash","","260","14702.25"
"23 Nov 2022","08:26 PM","Office","","Office Transport","Cash","","70","14632.25"
"24 Nov 2022","08:50 AM","Uber-to Kamlapur","","Tour","Cash","","500","14132.25"
"24 Nov 2022","11:50 AM","Chips and etc.","","Tour","Cash","","40","14092.25"
"24 Nov 2022","12:17 PM","Lunch","","Tour","Cash","","140","13952.25"
"26 Nov 2022","09:21 AM","Father=500, Shihab=20, Ma=100, Najma Bubu=100","","Gift","Cash","","720","13232.25"
"28 Nov 2022","09:14 AM","Bazar and etc. (Dhaka-Gaibandha-Baluahat)","","Tour","Cash","","3899.25","9333"
"28 Nov 2022","09:21 AM","Karmarpara to Baluahat=275, Meat=600 Sweets=150","","Tour","Cash","","1025","8308"
"29 Nov 2022","05:46 PM","Apple for Sazina Apu home","","Tour","Cash","","200","8108"
"29 Nov 2022","06:46 PM","Alovera Face Wash=180,Tibbet Pomet=60,Tikki=10","","Regular Bazar","Cash","","250","7858"
"30 Nov 2022","01:06 AM","Baluahat=70, Dhaka=550, Basha=150","","Tour","Cash","","770","7088"
"30 Nov 2022","08:06 AM","Office","","Office Transport","Cash","","70","7018"
"30 Nov 2022","01:01 PM","Vivo Display+cover","","Shopping","Cash","","2140","4878"
"30 Nov 2022","06:55 PM","Egg=115,Chanacur=15","","Regular Bazar","Cash","","130","4748"
"01 Dec 2022","08:27 AM","Office","","Office Transport","Cash","","65","4683"
"02 Dec 2022","03:45 PM","To Savar","","Tour","Cash","","100","4583"
"02 Dec 2022","03:45 PM","Sweets=200,Peyara=60,Badam=10,Jilaphi=40","","Tour","Cash","","310","4273"
"02 Dec 2022","07:47 PM","Recharge","Rabeya","Mobile Recharge","Cash","","30","4243"
"03 Dec 2022","09:24 AM","Office","","Office Transport","Cash","","95","4148"
"03 Dec 2022","07:00 PM","Banana=60,Chanacur,Facewash=180,Fair & Lovely=140","","Regular Bazar","Cash","","460","3688"
"04 Dec 2022","08:25 AM","Office","","Office Transport","Cash","","70","3618"
"05 Dec 2022","08:25 AM","Office","","Office Transport","Cash","","70","3548"
"05 Dec 2022","07:03 PM","Meat Moshla=18, Alu=30","","Regular Bazar","Cash","","48","3500"
"05 Dec 2022","08:27 PM","Meat","","Regular Bazar","Cash","","400","3100"
"06 Dec 2022","09:07 AM","Office","","Office Transport","Cash","","70","3030"
"07 Dec 2022","08:48 AM","Office","","Office Transport","Cash","","50","2980"
"07 Dec 2022","07:09 PM","Mushur Dal 1/2 kg","","Regular Bazar","Cash","","75","2905"
"08 Dec 2022","08:22 AM","Office","","Office Transport","Cash","","70","2835"